2,8,2,2,2,2,2,2,2,2,2,2,2,8,2,2,2,2,2,2,2,2,2,2,2,2,2,2,2,2,3,3,3,3,0,0,3,2,2,2,2,2,2,2,2,2,2,2,
2,2,2,2,2,2,2,2,2,2,2,2,2,2,2,8,2,2,2,2,2,2,2,2,2,2,2,2,2,2,3,3,3,3,0,0,3,2,2,2,2,2,2,2,2,2,2,3,
2,2,2,11,2,2,2,2,2,2,2,2,2,2,10,2,2,2,1,1,1,1,1,1,2,2,2,2,2,2,2,2,2,2,1,1,1,1,8,2,2,2,2,2,2,2,2,3,
2,2,2,2,2,2,2,2,2,2,2,2,2,2,2,2,2,2,1,1,1,1,1,1,1,1,1,1,1,1,1,1,1,1,1,1,1,1,2,2,2,2,2,2,2,2,2,2,
2,2,2,1,1,1,10,1,1,1,1,1,1,1,1,1,1,1,1,2,2,2,1,1,1,1,1,1,1,1,1,1,1,1,1,1,1,1,2,2,2,2,2,2,2,2,2,3,
2,2,2,1,1,1,1,1,1,1,1,1,1,1,1,1,1,1,1,2,2,2,2,1,1,8,2,2,2,2,10,2,2,2,2,2,2,1,1,1,1,8,1,2,2,2,3,3,
2,2,2,1,1,2,2,2,2,2,2,1,1,2,2,2,2,2,2,2,2,2,3,0,0,3,2,2,2,2,2,3,2,2,2,2,2,1,1,1,1,1,1,2,2,2,3,3,
2,2,8,1,1,2,2,2,2,2,2,1,1,2,2,2,2,10,2,3,2,3,3,0,0,3,3,3,2,2,3,3,3,2,2,2,2,2,2,2,8,1,1,2,2,2,2,3,
2,1,1,1,1,1,1,1,1,2,2,1,1,2,2,8,2,3,3,3,3,3,3,0,0,3,3,3,3,3,3,3,3,3,10,2,2,2,2,2,2,1,1,2,2,2,2,3,
2,1,1,1,1,10,1,1,1,2,2,1,1,2,2,2,2,2,3,3,3,3,3,0,0,3,3,3,3,3,3,3,2,2,2,2,2,2,2,2,2,1,1,2,2,2,2,2,
2,2,2,2,2,1,1,2,2,2,2,1,1,2,2,2,2,1,1,2,3,3,3,0,0,3,3,3,3,2,2,2,2,2,2,2,2,2,2,2,2,1,1,2,2,2,2,2,
3,2,2,2,2,1,1,2,2,2,2,1,1,1,1,1,1,1,1,3,3,3,2,1,1,2,2,2,2,2,2,2,2,2,2,1,1,1,1,1,1,1,1,2,2,2,2,2,
3,3,2,2,2,1,1,2,2,2,2,1,1,1,1,1,1,1,1,8,0,0,1,1,1,1,2,2,2,2,2,2,2,1,1,1,1,1,1,1,1,1,1,2,2,2,2,2,
3,3,2,2,2,1,1,1,1,10,1,1,1,2,2,2,2,1,1,0,10,0,1,1,1,1,1,1,1,1,1,1,1,1,1,1,1,2,2,2,2,1,1,2,2,2,2,2,
3,2,2,8,2,1,1,1,1,1,1,1,1,2,2,2,2,2,2,3,3,3,2,2,1,1,1,1,1,1,1,1,8,1,10,2,2,2,2,1,1,1,1,1,1,1,1,3,
3,2,2,2,2,1,1,2,2,2,2,2,2,2,2,2,2,2,3,3,3,3,3,2,1,1,2,2,2,1,1,2,2,2,3,2,2,3,3,1,1,1,1,1,1,1,1,3,
2,2,2,2,2,1,1,1,1,1,1,1,1,1,1,2,2,3,3,3,3,3,3,2,1,1,2,3,2,1,1,2,3,3,3,3,3,3,2,2,2,2,2,2,2,1,1,2,
3,2,2,2,2,1,1,1,1,1,1,1,1,1,1,2,3,3,3,3,3,3,3,3,2,2,3,3,2,1,1,2,3,3,3,3,3,3,3,3,3,3,2,2,2,1,1,2,
3,3,2,2,2,2,2,1,1,2,2,2,2,1,1,8,2,2,2,3,3,3,3,3,3,3,3,2,2,1,1,3,3,3,3,3,2,2,2,3,3,3,3,2,2,1,1,2,
3,2,2,2,2,2,2,1,1,2,2,2,2,1,1,1,1,1,1,0,10,0,0,0,1,1,1,1,1,1,1,0,0,0,1,1,1,1,1,1,2,3,3,3,8,1,1,2,
2,2,2,2,2,2,2,1,1,2,2,2,2,1,1,1,1,1,1,0,0,0,0,0,1,1,1,1,1,1,1,0,0,10,1,1,1,1,1,1,2,2,3,3,2,1,1,3,
2,2,2,2,10,2,2,1,1,2,2,2,2,2,2,2,2,2,3,0,0,3,3,3,3,3,3,3,3,3,3,3,3,3,1,1,2,2,1,1,2,2,2,2,2,1,1,2,
3,2,8,2,2,2,2,1,1,2,2,2,2,2,2,2,3,3,3,0,0,3,3,3,3,3,3,1,1,1,1,1,1,2,2,2,2,2,1,1,2,2,2,2,2,1,1,3,
3,3,3,2,2,1,1,1,1,2,2,2,2,2,3,3,3,3,3,0,0,1,1,1,1,1,1,1,1,1,1,1,1,1,1,1,1,1,1,1,1,1,1,1,1,1,1,3,
3,3,3,3,2,1,1,1,1,2,2,3,3,3,3,3,3,3,3,1,1,8,1,1,1,1,1,1,1,2,2,1,1,1,1,1,1,1,1,1,10,1,1,1,1,1,1,3,
3,3,3,2,2,1,1,2,2,3,3,3,3,3,3,3,3,3,3,1,1,1,2,2,2,2,2,1,1,2,2,2,2,2,2,2,2,2,2,2,2,1,1,1,2,2,3,3,
3,3,3,3,2,1,1,2,3,3,3,3,3,3,3,3,3,3,3,10,1,2,2,2,2,2,2,1,1,1,1,1,2,2,2,2,2,2,2,2,2,1,1,2,2,2,3,3,
3,3,3,3,3,0,0,3,3,3,3,2,2,2,2,2,3,3,3,1,1,2,2,2,2,2,2,1,1,1,1,1,2,2,2,2,12,2,2,1,1,1,1,2,2,2,2,3,
3,3,3,0,10,0,0,3,3,3,8,2,2,2,2,2,2,3,3,1,1,1,1,1,1,2,2,2,2,2,1,1,2,2,2,2,2,2,2,1,8,1,1,2,2,2,2,3,
3,3,3,0,0,0,0,3,3,3,2,2,2,2,2,2,2,2,3,0,0,1,1,1,1,2,2,2,1,1,1,10,1,1,2,2,2,2,2,2,2,1,1,2,2,2,2,3,
3,3,3,3,3,0,0,0,0,0,1,1,1,1,1,1,1,1,1,0,0,3,3,1,1,2,2,2,1,1,1,1,1,1,2,2,2,2,2,2,2,1,1,2,2,2,3,3,
3,3,3,3,3,0,0,0,0,0,1,1,1,1,1,1,1,1,1,0,0,3,3,1,1,1,1,1,1,1,2,2,1,1,1,1,1,10,1,1,1,1,1,2,2,3,3,3,
3,3,3,3,3,3,3,0,0,3,3,2,2,2,2,2,2,2,1,1,1,1,1,1,1,1,1,1,1,1,2,2,1,1,1,1,1,1,1,1,1,1,1,2,2,3,3,3,
3,3,2,2,3,3,3,0,0,3,3,3,2,2,2,2,2,2,1,1,1,1,1,1,1,2,2,2,2,1,2,2,2,2,2,2,2,2,2,2,2,2,3,3,3,3,3,3,
3,2,2,2,2,3,3,10,0,3,3,3,3,3,3,3,2,2,2,2,2,1,1,2,2,2,2,2,1,1,2,2,2,2,2,2,2,2,2,3,3,3,3,3,3,3,3,3,
3,10,2,2,2,2,3,0,0,3,3,3,3,3,3,2,2,2,2,1,1,1,1,2,2,2,2,2,1,1,2,10,2,2,3,3,3,3,3,3,3,3,3,3,3,3,3,3,
3,2,2,2,2,2,3,0,0,3,3,3,3,3,3,3,2,2,2,1,1,1,1,2,2,2,2,2,1,1,2,2,3,3,3,3,3,3,3,3,3,3,3,3,3,3,3,3,
2,8,2,2,2,2,2,1,1,2,3,3,3,3,2,2,2,2,2,1,1,2,2,2,2,3,3,2,0,0,8,3,3,3,3,3,3,3,3,3,3,3,3,3,3,3,3,3,
3,2,2,2,2,2,2,1,1,2,2,2,2,2,2,2,2,1,1,1,1,2,2,2,3,3,3,3,0,0,3,3,3,3,3,3,3,3,3,3,3,3,3,3,3,3,3,3,
3,3,2,2,1,10,1,1,1,1,1,1,1,1,1,1,1,1,1,1,1,1,1,1,0,0,0,0,0,0,3,3,3,3,3,3,3,3,3,3,3,3,3,3,3,3,3,3,
3,3,2,2,1,1,1,1,1,1,1,1,1,1,1,1,1,1,1,1,10,1,1,1,0,0,0,0,0,0,3,3,3,3,3,3,3,3,3,3,3,3,3,3,3,3,3,3,
3,3,3,2,1,1,2,2,2,2,2,1,1,2,2,2,2,1,1,2,2,2,2,2,3,3,3,3,0,8,3,3,3,3,3,3,3,3,3,3,3,3,3,3,3,3,3,3,
3,3,3,2,1,1,2,2,2,2,2,1,1,2,2,2,2,1,1,8,2,2,2,2,3,3,3,3,0,0,0,0,3,3,3,3,3,3,3,3,3,3,3,3,3,3,3,3,
0,8,3,2,1,10,2,2,2,2,2,1,1,2,2,2,2,1,1,2,2,2,2,2,2,3,3,3,0,0,0,0,3,3,3,3,3,3,3,3,3,3,3,3,3,3,3,3,
0,0,0,0,1,1,1,1,1,1,1,1,1,1,1,1,1,1,1,1,10,1,1,8,1,0,10,0,0,0,3,3,3,3,3,3,3,3,3,3,3,3,3,3,3,3,3,3,
0,0,0,0,1,1,1,1,1,1,1,1,1,1,1,1,1,1,1,1,1,1,1,1,1,0,0,0,0,0,3,3,3,3,3,3,3,3,3,3,3,3,3,3,3,3,3,3,
0,0,3,3,3,3,2,2,2,2,2,2,2,2,8,2,2,2,2,2,2,2,2,3,3,3,3,3,3,3,3,3,3,3,3,3,3,3,3,3,3,3,3,3,3,3,3,3,
0,0,3,3,3,3,3,3,3,3,3,3,3,3,3,3,3,3,3,3,3,3,3,3,3,3,3,3,3,3,3,3,3,3,3,3,3,3,3,3,3,3,3,3,3,3,3,3,
